1111P1111111111111111111111111111111
10100000100000000000C000010000T10001
100010111110111111111111010111111101
11101L101010100001000000010000001001
100010101010111101111101010111111011
10111010101010100000000101000000T001
100010001010101001111111110111111111
1010111110101010000000000000000010C1
101010000010101111111111111111001011
1C1000111000C00000000000L00000000001
11111111111111111111111111111F111111
