11111111111111111111111111111111111111111
10100000010000000000000000000010000010001
10001011111011111111111111111010111111101
11101000000000000000001000000010000001001
10001000000000000000001111101010111111011
10111000000000000000000000001010000000001
10001000000000000000001111111110111111111
10101110000000000000000000000000000001001
10101000000000000000000000000000000001011
10100000000000000000000000000000000000001
10100000000000000000000000000000000000001
10100000000000000000000000000000000000001
10100000000000000000000000000000000000001
10100000000000000000000000000000000000001
10100000000000000000000000000000000000001
10100000000000000000000000000000000000001
10100000000000000000000000000000000000001
10100000000000000000000000000000000000001
10100000000000000000000000000000000000001
10100000000000000000000000000000000000001
10100000000000000000000000000000000000001
10100000000000000000000000000000000000001
10100000000000000000000000000000000000001
10100000000000000000000000000000000000001
10100000000000000000000000000000000000001
11111111111111111111111111111111111111111
