111111F111
1000000001
10H0100001
1000111011
1000000001
1111011001
1001010011
P0C0010111
1001000001
1111111111