11111111111111111111
11P00000000000000001
11111111111111111101
111111111111111111L1
100000C00000C0000001
10111111111111111111
1F111111111111111111
