11111111111111111111
11P00000000000000001
11111111111111111101
11111111111T111111L1
100000CT0000C0000001
10111111111T11111111
1F111111111111111111
