######o####
#        ##
# H #    ##
#   ### ###
#        ##
#### ##  ##
# T# #  ###
# $  # ####
#  #     ##
##%########