        ####o#####
        # #   # ##
        #   T   ##
        # #   # ##
        #       ##
        # #   # ##
#########   $   ##
# H T # # #   # ##
#       #       ##
#     # # #   # ##
####### #   H   ##
#       # #   # ##
# ##### #### #####
# #   #       # ##
# # # ######### ##
#   #     #   # ##
#####  ##   T   ##
#       ### $ # ##
# #       #   # ##
# ####### ##### ##
#               ##
#########%########