1P111111111111111111
10000000000000000011
11111111111111111001
10000L0000CC00000001
10111111111111111111
1000000000000000000F
11111111111111111111
