000000001111F1111
00000000101000101
000000001000T0001
00000000101000101
00000000100000001
00000000101000101
111111111000C0001
10C0T010101000101
10000000100000001
10000010101000101
111111101000H0001
10000000101000101
10111110111101111
10100010000000101
10101011111111101
10001000001000101
111110011000T0001
100000001110C0101
10100000001000101
10111111101111101
10000000000000001
111111111P1111111