#######o#########
#          #   ##
# ### ####     ##
#   #  $#  #   ##
#####   #########
#   #      #   ##
#  ######### T ##
#  #   #   #   ##
#    # # # ######
###### # # #   ##
# #      #   T ##
# #   H$ # # T ##
#     $H # #   ##
# #      # ## ###
# ######## #   ##
#          # $ ##
####%############