1111111111111111
1000000000010001
1011101111000001
1000100C10010001
111010001001000F
1000100000010001
1001111111110T01
1001000100010001
1000010101011111
1111110101010001
1010000001000T01
101000LC01010T01
100000CL01010001
1010000001011011
1011111111010001
1000000000010C01
1111P11111111111