###########o####
#   H#        ##
# #  # ## ### ##
# #  # #    # ##
# #  # #  # # ##
# #      $#   ##
# #      $#   ##
#    # #### # ##
#    #      # ##
############# ##
#       #     ##
#  # #  #  #####
# #   # #     ##
#   T   ##### ##
#   T     #   ##
# #   # # # ####
#  # #  # #   ##
#       #     ##
####%###########