111111111111111
1000L1000000001
101001011011101
101001010000101
P01001010010101
101000000C10001
101000000C10001
100001011110101
100001000000101
111111111111101
100000001000001
100101001001111
101000101000001
1000T0001111101
1000T0000010001
101000101010111
100101001010001
100000001000001
1111F1111111111