###########o###############
#      #       #         ##
# ###  # ##### # #  H$T$ ##
# #$# ##       # #  H$TT ##
#   #     ## ### ###     ##
### #### ##  #     #     ##
#      #     # #T  ### ####
# #  # ####### ### #     ##
#  $$        #     # # # ##
# #  # ##### # #####  T  ##
#      #   #   #   # # # ##
######## T ##### # #  $  ##
#    #     #     # # # # ##
# #  # # ###  $### #     ##
# ##   #  #  ###   # # # ##
#  ###### #    # ##### ####
#    #    #    # #       ##
###  # # $#### # #  #### ##
#T   # ####  # #      T# ##
#    #         # ## #### ##
#    #     ##  # #       ##
##%########################