11111111111P11111111111111
10000001000000010000000001
10111001011111010100HCTC01
101C1011000000010100HCTT01
10001000001101110111000001
11101111011001000001000001
1000000100000101T001110111
10100101111111011101000001
100CC000000001000001010101
1010010111110101111100T001
10000001000100010001010101
111111110T011111010100C001
10000100000100000101010101
10100101011100C11101000001
10110001001001110001010101
10011111101000010111110111
10000100001000010100000001
111001010C1111010100111101
1T00010111100101000000T101
10000100000000010110111101
10000100000110010100000001
11F11111111111111111111111