11111P111111111111111111111
1001001000001010101010101H1
100000100100100000000000101
101111110101101010101010101
100000100100100000100000001
100100100100001110001011011
110101101111100000100010001
100100100000101010101010101
10010010010010000000000000F
1CC10000010T101010101010101
111111111111111111111111111