#####o######################
#  #  #     # # # # # # #H##
#     #  #  #           # ##
# ###### # ## # # # # # # ##
#     #  #  #     #       ##
#  #  #  #    ###   # ## ###
## # ## #####     #   #   ##
#  #  #     # # # # # # # ##
#  #  #  #  #             ##
#$$#     # T# # # # # # # ##
########%###################