############# ######
# HH #       o #$T##
#    # #####   #  ##
# # ##   # #####  ##
# #    #    #     ##
# ## ### ## # ######
#           # # HT##
# # # # # #   #   ##
#           ### # ##
# #  #T#  #     # ##
#   #   #   ##### ##
# # $ H $ #       ##
#   #   #   ########
# #  #H#  #   # $ ##
#           #     ##
# # # # # # ##### ##
#               # ##
# ## #### ##### # ##
# #  #TH#     #   ##
# #  #  ##### #   ##
# # #         ### ##
#      # # ##   # ##
# ### ## # #    # ##
#   #    #   #    ##
#   # ######## #  ##
#  #       #   #  ##
# #   ## # # ###  ##
# ###    # #      ##
#     ####   #    ##
#####%##############