1111111111111F11111
10HH010000000001CT1
1000010111110001001
1010110001011111001
1010000100001000001
1011011101101011111
1000000000001010TT1
1010101010100010001
1000000000001110101
101001T100100000101
1000100010001111101
1010C0H0C0100000001
1000100010001111111
101001H100100010C01
1000000000001000001
1010101010101111101
1000000000000000101
1011011110111110101
101001TT10000010001
1010010011111010001
1010100000000011101
1000000101011000101
1011101101010000101
1000100001000100001
1000101111111101001
1001000000010001001
1010001101010111001
P011100001010000001
1000001111000100001
1111111111111111111